DESK	D EH S K
GO	G OW
HALLWAY	HH AO L W EY
KEN	K EH N
KEN'S	K EH N Z
LAB	L AE B
LYNN	L IH N
LYNN'S	L IH N Z
MIKE	M AY K
MIKE'S	M AY K S
NICK	N IH K
NICK'S	N IH K S
OFFICE	AO F AH S
SAMIRA'S	S AE M AH R AH Z
TAKE	T EY K
THE	DH AH
THE(2)	DH IY
THIS	DH IH S
TO	T UW
TO(2)	T IH
TO(3)	T AH
TOMEK	T OW M EH K
TOMEK'S	T OW M EH K S
